111111111111111111111
100000000000100000011
110000P00000100000001
100000101000CC0000011
100000101C01100000011
100000101001111111111
100000101001111111111
1000E01010011C0000011
10000C001010100000011
111111111111111111111