111111111111111111111
100E00000000100000011
110000P00000100000001
100000101000CC0000011
100000101C01100000011
10UD00101001111111111
10B000101000011111111
1000001010000C0000011
10000C001010100000011
111111111111111111111